11111111
1C000001
101P00E1
11111111