11111111
1P100001
101C00E1
11111111
