11111111
1C100001
101P00E1
11111111
