11111111
1P000000
100000E1
11111111
