1111111111111
1E0000C00P0E1
1111111111111