11111111
1P0C0001
10W000E1
11111111
