11111111
10000001
100000001
11111111
