11111111111111111111111111111111111111111111111111111111111111111111111111111111111111111
1P100000000000000000000000000000000000000000000000000000000000000000000000000000000000001
101C00E0000000000000000000000000000000000000000000000000000000000000000000000000000000001
10000000000000000000000000000000000000000000000000000000000000000000000000000000000000001
10000000000000000000000000000000000000000000000000000000000000000000000000000000000000001
10000000000000000000000000000000000000000000000000000000000000000000000000000000000000001
11111111111111111111111111111111111111111111111111111111111111111111111111111111111111111
