1111111111111111111111111111111111111111111111111111111111111111111111111111111111111111111
1P10000000000000000000000000000000000000000000000000000000000000000000000000000000000000001
101C00E000000000000000000000000000000000000000000000000000000000000000000000000000000000001
1000000000000000000000000000000000000000000000000000000000000000000000000000000000000000001
1000000000000000000000000000000000000000000000000000000000000000000000000000000000000000001
1000000000000000000000000000000000000000000000000000000000000000000000000000000000000000001
1111111111111111111111111111111111111111111111111111111111111111111111111111111111111111111
