1111111
10PCE11
1111111

//empty file
//image error