11111111
1E100001
101C00P1
11111111
