11111111
1C10C001
101P00E1
11111111
