1111111111111
1P0000C00P0E1
1111111111111