11111111111111111111111111111111
1P000100000000000000000000000001
100001C0000000E00000000000000001
10000111001C11100000000000000001
100000010C1100000000000000000001
10000100000000000001001000000001
10000001110101010000000000000001
10000000000000000000000000000001
11111111111111111111111111111111
