111111111111111111111111111111111111111111111111111111111111111111111111111111111111111111
1P1000000000000000000000000000000000000000000000000000000000C00000000000000000000000000001
101C00E00000000000000000000000000000000000000000000000000000C00000000000000000000000000001
100000000000000000000000000000000000000000000000000000000000C00000000000000000000000000001
100000000000000000000000000000000000000000000000000000000000C00000000000000000000000000001
100000000000000000000000000000000000000000000000000000000000C00000000000000000000000000001
100000000000000000000000000000000000000000000000000000000000C00000000000000000000000000001
100000000000000000000000000000000000000000000000000000000000C00000000000000000000000000001
100000000000000000000000000000000000000000000000000000000000C00000000000000000000000000001
100000000000000000000000000000000000000000000000000000000000C00000000000000000000000000001
100000000000000000000000000000000000000000000000000000000000C00000000000000000000000000001
100000000000000000000000000000000000000000000000000000000000C00000000000000000000000000001
100000000000000000000000000000000000000000000000000000000000C00000000000000000000000000001
100000000000000000000000000000000000000000000000000000000000C00000000000000000000000000001
100000000000000000000000000000000000000000000000000000000000C00000000000000000000000000001
100000000000000000000000000000000000000000000000000000000000C00000000000000000000000000001
100000000000000000000000000000000000000000000000000000000000C00000000000000000000000000001
100000000000000000000000000000000000000000000000000000000000C00000000000000000000000000001
100000000000000000000000000000000000000000000000000000000000C00000000000000000000000000001
100000000000000000000000000000000000000000000000000000000000C00000000000000000000000000001
100000000000000000000000000000000000000000000000000000000000C00000000000000000000000000001
100000000000000000000000000000000000000000000000000000000000C00000000000000000000000000001
100000000000000000000000000000000000000000000000000000000000C00000000000000000000000000001
100000000000000000000000000000000000000000000000000000000000C00000000000000000000000000001
100000000000000000000000000000000000000000000000000000000000C00000000000000000000000000001
100000000000000000000000000000000000000000000000000000000000C00000000000000000000000000001
100000000000000000000000000000000000000000000000000000000000C00000000000000000000000000001
100000000000000000000000000000000000000000000000000000000000C00000000000000000000000000001
100000000000000000000000000000000000000000000000000000000000C00000000000000000000000000001
100000000000000000000000000000000000000000000000000000000000C00000000000000000000000000001
100000000000000000000000000000000000000000000000000000000000C00000000000000000000000000001
100000000000000000000000000000000000000000000000000000000000C00000000000000000000000000001
100000000000000000000000000000000000000000000000000000000000C00000000000000000000000000001
100000000000000000000000000000000000000000000000000000000000C00000000000000000000000000001
100000000000000000000000000000000000000000000000000000000000C00000000000000000000000000001
100000000000000000000000000000000000000000000000000000000000C00000000000000000000000000001
100000000000000000000000000000000000000000000000000000000000C00000000000000000000000000001
100000000000000000000000000000000000000000000000000000000000C00000000000000000000000000001
100000000000000000000000000000000000000000000000000000000000C00000000000000000000000000001
100000000000000000000000000000000000000000000000000000000000C00000000000000000000000000001
100000000000000000000000000000000000000000000000000000000000C00000000000000000000000000001
100000000000000000000000000000000000000000000000000000000000C00000000000000000000000000001
100000000000000000000000000000000000000000000000000000000000C00000000000000000000000000001
100000000000000000000000000000000000000000000000000000000000C00000000000000000000000000001
100000000000000000000000000000000000000000000000000000000000C00000000000000000000000000001
100000000000000000000000000000000000000000000000000000000000C00000000000000000000000000001
100000000000000000000000000000000000000000000000000000000000C00000000000000000000000000001
100000000000000000000000000000000000000000000000000000000000C00000000000000000000000000001
100000000000000000000000000000000000000000000000000000000000C00000000000000000000000000001
100000000000000000000000000000000000000000000000000000000000C00000000000000000000000000001
100000000000000000000000000000000000000000000000000000000000C00000000000000000000000000001
100000000000000000000000000000000000000000000000000000000000C00000000000000000000000000001
111111111111111111111111111111111111111111111111111111111111111111111111111111111111111111
