111111111
1P0001001
100100CE1
111111111
